ПО - Tarkvara
Процесс разработки ПО - Tarkvara arendusprotsess
Документация на ПО - Tarkvara dokumentatsioon
Проект - project
ИТ проект - IT projekt
Бизнес-проект - äri projekt
Проект по разработке - Arendus projekt
Проект по реализации - realiseerimis projekt
Диаграмма Ганта - Gantti diagramm
UML схема - UML skeem
Диаграмма прецедентов - 
Диаграмма последовательности - 
Диаграмма состояний - 
Диаграмма активности - 
Диаграмма классов - 
Диаграмма взаимодействий - 
Схема (диаграмма) баз данных- Andmebaasi diagramm
CASE-средства - CASE cahendid
-------------------------------------------
Архитектурная/проектная документация - arhitektuuri/projektidokumentatsioon
Техническая документация - tehniline dokumentatsioon
Пользовательская документация - kasutaja dokumentatsioon
Система управления версиями - versioonihaldus süsteem
Локальное управление - kohalik juhtimine
Централизованное управление - tsentraliseeritud juhtimine
Распределенное управление - hajutatud juhtimine
Критический путь проекта - projekti kriitiline tee
Аутсорсинг - Allhange
Краудсорсинг - Ühishange
IT аудит - IT audit
ERP системы - ERP süsteemid
--------------------------------------------
Методики - meetodid
Каскадная модель - Koskmudel
Спиральная модель  - Spiraalmudel/spiraalne mudel
Инкрементальная модель - inkrementaalne mudel
Прототированная модель - prototüübimudel
V-модель - V-mudel
Агильная модель - agiilne mudel
Cистемы управления базами данных - Andmebaaside haldussüsteemid
Организация проекта - Projekti orgatsioon
Обмен информацией - Infovahetus
Расходы - kulud
Доходы - tulud
Качество - Kvaliteet
Валидирование - valideerimine
Служба поддержки - tugi teenus
--------------------------------------------
lisa veel 10 sõna
